E E E E E E E E E E E E E E E E E E E E E E E E E E E E E E E E
E 0 A A A A A A A A A A A A A A A A A A A A A A A A A A A A A E
E A A A A A A A 5 A A A A E E A A A A A A A A A A A A A A A A E
E E E A E A A E E E A E E E E E A A A A A A A E E A A A A A A E
E A A A A A A A A A 3 A A A E E E A A A A A A E E A A E A A A E
E F F F F E E E E E F F F F F F F F F F F F F E E E E E E A A E
E A E E E E A E A E E E A E E E E E E E E E E E E A E E E A A E
E W E E E E F E F F E F F F F E E A A A A A E E E A A A A A A E
E W E E E E F F F F F F F 1 F E E A A A A A A E E E A A A 4 A E
E W W E E E E E E E E E F F F E E F E A E A A E E E A A E E A E
E W W E E E E A A A E E E E F E F F E W E W W A A A A E E E F E
E W W E E E E A A A A A E E F E F F E W W W E E A A E E E F F E
E W E E E E E A A E E F F E F F F F E E W W E F F E E F F F F E
E W E E E E E E E E E E F F F F F F F F W W F F F F F F F F F E
E W W E E E E E W W E E E E E E W W F F W W F F F F F F E E E E
E W W W E E E W W W W W W W W W W 2 W W W W W W W W W E E E E E
E W W W W W W W W W W W W W W W W W W W W W W W W W E E E E E E
E E E E E E E E E E E E E E E E E E E E E E E E E E E E E E E E
